#################
#               #
#               #
#   A           #
#               #
#               #
#               #
#               #
#        S      #
#               #
#               #
#################